9
..o..........o....o...o.o..
o...o......................
............o..............
....................o......
....o......................
...............o...........
...........................
......o..............o.....
..o.......o................
