10
..........
..........
..........
....o.....
...o......
..........
..........
oo........
...o......
..........
