10
..........
..........
.......oo.
o........o
.........o
..........
........o.
......o..o
..........
..........
