10
...o...o..
.o...o...o
.o.o..ooo.
o...ooo.oo
....o.o.o.
..o..o.o..
.o.....o..
o.oo...oo.
.oo.o.....
......o...
