10
.o....oooo
..o.o.....
.o........
.....o...o
.oo...oo..
........oo
.o........
...o..oo..
.......oo.
.......o..
