10
.....oo..o
...o.....o
.oo.......
.o......oo
o.o.o.oo..
...o.....o
o.........
o.o......o
..ooooooo.
....o..o..
